***********************************|***********************************
***********************************|********************P**************
***********************************N***********************************
***********************N***********|***********************************
***********************************|***********************************
***********************************|***********************************
....*******************************|***********************************
............****P******************|***********************************
....................***************|****************************P******
............................****P**|***********************************
-----------------------------------+-------------------------N---------
...................................|.......****************************
......................N............|...............**N*P**P************
...................................|.......................************
................N..................|...............................****
..............P....................|...................................
..............N....................|...................................
...........................N......N|...................................
...................................|...................................
...................................|...................................
...................................|...................................

...................................|...........************************
...................................|..........**********P**************
...................................N.........**************************
.......................N...........|........***************************
...................................|......*****************************
...................................|.....******************************
...................................|....*******************************
................P..................|...********************************
...................................|..**************************P******
................................P..|.**********************************
-----------------------------------+-------------------------N---------
..................................*|***********************************
......................N..........**|*****************N*P**P************
................................***|***********************************
................N..............****|***********************************
..............P...............*****|***********************************
..............N..............******|***********************************
...........................N******N|***********************************
..........................*********|***********************************
.........................**********|***********************************
........................***********|***********************************

...........................********|***********************************
............................*******|********************P**************
.............................******N***********************************
.......................N......*****|***********************************
...............................****|***********************************
...............................****|***********************************
................................***|***********************************
................P................**|***********************************
..................................*|****************************P******
................................P..|***********************************
-----------------------------------+-------------------------N---------
...................................|***********************************
......................N............|.****************N*P**P************
...................................|..*********************************
................N..................|...********************************
..............P....................|....*******************************
..............N....................|....*******************************
...........................N......N|.....******************************
...................................|......*****************************
...................................|.......****************************
...................................|........***************************

*************************..........|...................................
**************************.........|....................P..............
***************************........N...................................
***********************N****.......|...................................
*****************************......|...................................
******************************.....|...................................
*******************************....|...................................
****************P***************...|...................................
*********************************..|............................P......
********************************P*.|...................................
-----------------------------------+-------------------------N---------
***********************************|*..................................
**********************N************|**...............N.P..P............
***********************************|***................................
****************N******************|****...............................
**************P********************|*****..............................
**************N********************|******.............................
***************************N******N|*******............................
***********************************|********...........................
***********************************|*********..........................
***********************************|**********.........................

...................................|...........************************
...................................|..........**********P**************
...................................N.........**************************
.......................N...........|........***************************
...................................|.......****************************
...................................|.....******************************
...................................|....*******************************
................P..................|...********************************
...................................|..**************************P******
................................P..|.**********************************
-----------------------------------+-------------------------N---------
..................................*|***********************************
......................N..........**|*****************N*P**P************
................................***|***********************************
................N..............****|***********************************
..............P...............*****|***********************************
..............N.............*******|***********************************
...........................N******N|***********************************
..........................*********|***********************************
.........................**********|***********************************
........................***********|***********************************

...................................|***********************************
...................................|********************P**************
...................................N***********************************
.......................N...........|***********************************
...................................|***********************************
...................................|***********************************
...................................|***********************************
................P..................|***********************************
...................................|****************************P******
................................P..|***********************************
-----------------------------------+-------------------------N---------
...................................|***********************************
......................N............|*****************N*P**P************
...................................|***********************************
................N..................|***********************************
..............P....................|***********************************
..............N....................|***********************************
...........................N......N|***********************************
...................................|***********************************
...................................|***********************************
...................................|***********************************

***********************************|************.......................
***********************************|***********.........P..............
***********************************N**********.........................
***********************N***********|********...........................
***********************************|*******............................
***********************************|******.............................
***********************************|*****..............................
****************P******************|***................................
***********************************|**..........................P......
********************************P**|*..................................
-----------------------------------+-------------------------N---------
**********************************.|...................................
**********************N**********..|.................N.P..P............
********************************...|...................................
****************N*************.....|...................................
**************P**************......|...................................
**************N*************.......|...................................
***************************N......N|...................................
*************************..........|...................................
************************...........|...................................
***********************............|...................................

***********************************|******************.................
***********************************|****************....P..............
***********************************N**************.....................
***********************N***********|************.......................
***********************************|***********........................
***********************************|*********..........................
***********************************|*******............................
****************P******************|*****..............................
***********************************|***.........................P......
********************************P**|*..................................
-----------------------------------+-------------------------N---------
**********************************.|...................................
**********************N*********...|.................N.P..P............
******************************.....|...................................
****************N***********.......|...................................
**************P***********.........|...................................
**************N*********...........|...................................
***********************....N......N|...................................
*********************..............|...................................
*******************................|...................................
*****************..................|...................................

***************************........|...................................
****************************.......|....................P..............
*****************************......N...................................
***********************N******.....|...................................
*******************************....|...................................
*******************************....|...................................
********************************...|...................................
****************P****************..|...................................
**********************************.|............................P......
********************************P**|...................................
-----------------------------------+-------------------------N---------
***********************************|...................................
**********************N************|*................N.P..P............
***********************************|**.................................
****************N******************|***................................
**************P********************|****...............................
**************N********************|****...............................
***************************N******N|*****..............................
***********************************|******.............................
***********************************|*******............................
***********************************|********...........................

...............********************|***********************************
.................******************|********************P**************
...................****************N***********************************
.....................**N***********|***********************************
.......................************|***********************************
.........................**********|***********************************
...........................********|***********************************
................P............******|***********************************
...............................****|****************************P******
................................P**|***********************************
-----------------------------------+-------------------------N---------
...................................|..*********************************
......................N............|....*************N*P**P************
...................................|......*****************************
................N..................|........***************************
..............P....................|..........*************************
..............N....................|............***********************
...........................N......N|..............*********************
...................................|................*******************
...................................|..................*****************
...................................|....................***************

******************************.....|...................................
******************************.....|....................P..............
*******************************....N...................................
***********************N********...|...................................
********************************...|...................................
*********************************..|...................................
*********************************..|...................................
****************P*****************.|...................................
**********************************.|............................P......
********************************P**|...................................
-----------------------------------+-------------------------N---------
***********************************|...................................
**********************N************|*................N.P..P............
***********************************|*..................................
****************N******************|**.................................
**************P********************|**.................................
**************N********************|***................................
***************************N******N|***................................
***********************************|****...............................
***********************************|*****..............................
***********************************|*****..............................

...................................|.**********************************
...................................|.*******************P**************
...................................N***********************************
.......................N...........|***********************************
...................................|***********************************
...................................|***********************************
...................................|***********************************
................P..................|***********************************
...................................|****************************P******
................................P..|***********************************
-----------------------------------+-------------------------N---------
...................................|***********************************
......................N............|*****************N*P**P************
...................................|***********************************
................N..................|***********************************
..............P....................|***********************************
..............N....................|***********************************
...........................N......N|***********************************
...................................|***********************************
..................................*|***********************************
..................................*|***********************************

