...................................|....*******************************
...................................|...********************************
......P............................|...********************************
...................................|..*********************************
...................................|..*********************************
...................................|..*********************************
...................................|.*P********************N***********
...................................|.**********************************
...................................|***********************************
...................................|***********************************
-----------------------------------+-----------------------------------
...................................|***********************************
...................................|***********************************
..................................*|***********************************
..................................*|***********************************
.................................**|***********************************
.................................**|***********************************
.................................**|***********************************
................................***|***********************************
................................***|***********************************
...............................****|***********************************

